no,name,kor,eng,math,total,avg
1,Eddie,84,53,52,189,63
2,Netti,56,74,57,187,62.3333333333
3,Bertrand,59,59,63,181,60.3333333333
4,Lanny,69,69,62,200,66.6666666667
5,Hally,58,59,63,180,60
6,Rafi,98,85,57,240,80
7,Tommie,78,59,62,199,66.3333333333
8,Lorens,53,100,91,244,81.3333333333
9,Andria,89,56,85,230,76.6666666667
10,Domenic,60,85,70,215,71.6666666667
11,Gardener,78,78,87,243,81
12,Brannon,63,100,69,232,77.3333333333
13,Jonell,77,60,95,232,77.3333333333
14,Linda,95,75,83,253,84.3333333333
15,Lianna,100,62,89,251,83.6666666667
16,Uri,85,67,100,252,84
17,Patin,71,56,95,222,74
18,Trevor,92,92,79,263,87.6666666667
19,Kathlin,63,94,50,207,69
20,Hurlee,93,80,99,272,90.6666666667
21,Che,54,79,97,230,76.6666666667
22,Vivianne,86,78,69,233,77.6666666667
23,Theda,98,77,77,252,84
24,Livia,50,75,92,217,72.3333333333
25,Winn,97,61,100,258,86
26,Steffie,96,74,52,222,74
27,Darb,51,96,92,239,79.6666666667
28,Stanislas,99,56,77,232,77.3333333333
29,Erroll,100,57,95,252,84
30,Irvin,63,91,72,226,75.3333333333
31,Cristiano,91,97,55,243,81
32,Regina,65,79,71,215,71.6666666667
33,Ignatius,77,78,88,243,81
34,Nessie,78,70,89,237,79
35,Titos,82,62,72,216,72
36,Delilah,92,89,52,233,77.6666666667
37,Devonne,96,52,50,198,66
38,Emmeline,77,89,75,241,80.3333333333
39,Glori,81,77,87,245,81.6666666667
40,Nikola,94,72,89,255,85
41,Norby,63,98,79,240,80
42,Niles,51,60,89,200,66.6666666667
43,Kat,99,58,78,235,78.3333333333
44,Almeda,71,91,82,244,81.3333333333
45,Elane,84,87,57,228,76
46,Lizbeth,77,72,70,219,73
47,Regan,83,70,68,221,73.6666666667
48,Essa,91,63,65,219,73
49,Angeli,72,84,80,236,78.6666666667
50,Thacher,80,64,80,224,74.6666666667
51,Yoshiko,63,55,62,180,60
52,Wolfy,64,75,87,226,75.3333333333
53,Darrelle,61,73,58,192,64
54,Kalle,88,56,77,221,73.6666666667
55,Colby,85,70,63,218,72.6666666667
56,Elroy,100,91,85,276,92
57,Trista,88,62,67,217,72.3333333333
58,Karoly,51,50,75,176,58.6666666667
59,Antin,74,89,58,221,73.6666666667
60,Roberta,67,81,76,224,74.6666666667
61,Linnie,93,99,57,249,83
62,Colleen,89,53,88,230,76.6666666667
63,Dale,57,92,56,205,68.3333333333
64,Evita,59,52,74,185,61.6666666667
65,Archer,84,100,65,249,83
66,Heddi,90,83,57,230,76.6666666667
67,Reinold,60,100,89,249,83
68,Bink,90,52,54,196,65.3333333333
69,Craggie,79,73,62,214,71.3333333333
70,Sayers,92,90,96,278,92.6666666667
71,Klement,72,76,74,222,74
72,Shina,77,80,73,230,76.6666666667
73,Mattheus,62,62,54,178,59.3333333333
74,Truda,55,80,60,195,65
75,Avis,87,71,79,237,79
76,Orton,64,59,70,193,64.3333333333
77,Jens,88,91,59,238,79.3333333333
78,Benjamin,97,54,95,246,82
79,Celesta,71,74,79,224,74.6666666667
80,Calley,55,99,67,221,73.6666666667
81,Rivalee,57,93,82,232,77.3333333333
82,Morgan,52,56,70,178,59.3333333333
83,Trent,67,86,81,234,78
84,Meredeth,97,50,96,243,81
85,Kerstin,56,82,87,225,75
86,Bryanty,70,90,80,240,80
87,Emerson,98,92,72,262,87.3333333333
88,Sinclair,58,80,55,193,64.3333333333
89,Gothart,72,68,80,220,73.3333333333
90,Jess,52,80,82,214,71.3333333333
91,Zebulon,96,67,97,260,86.6666666667
92,Gussi,58,83,87,228,76
93,Mella,80,65,85,230,76.6666666667
94,Alaric,82,97,63,242,80.6666666667
95,Cordy,62,72,76,210,70
96,Faun,50,94,52,196,65.3333333333
97,Karissa,77,56,76,209,69.6666666667
98,Johanna,50,77,69,196,65.3333333333
99,Sigrid,93,79,58,230,76.6666666667
100,Gilbert,99,99,50,248,82.6666666667
101,Glori,58,96,93,247,82.3333333333
102,Kennedy,73,61,78,212,70.6666666667
103,Francesca,56,94,73,223,74.3333333333
104,Knox,79,85,56,220,73.3333333333
105,Cinda,75,70,85,230,76.6666666667
106,Janeta,66,61,69,196,65.3333333333
107,Harcourt,74,84,86,244,81.3333333333
108,Cordy,71,82,79,232,77.3333333333
109,Caleb,96,60,95,251,83.6666666667
110,Corette,70,96,54,220,73.3333333333
111,Sonni,99,90,86,275,91.6666666667
112,Hall,89,96,54,239,79.6666666667
113,Mayer,82,51,58,191,63.6666666667
114,Kayley,58,66,55,179,59.6666666667
115,Fee,57,89,89,235,78.3333333333
116,Lodovico,70,50,66,186,62
117,Milton,57,92,93,242,80.6666666667
118,Shae,54,50,85,189,63
119,Enos,73,78,65,216,72
120,Antoinette,83,88,100,271,90.3333333333
121,Ogden,72,62,72,206,68.6666666667
122,Allys,90,61,56,207,69
123,Cale,93,75,66,234,78
124,Dwight,91,96,98,285,95
125,Carlos,82,94,84,260,86.6666666667
126,Alexandrina,54,86,72,212,70.6666666667
127,Brucie,74,77,87,238,79.3333333333
128,Pamela,90,80,60,230,76.6666666667
129,Duff,94,58,96,248,82.6666666667
130,Brade,69,52,86,207,69
131,Greer,61,86,78,225,75
132,Oren,86,70,84,240,80
133,Iorgo,72,54,75,201,67
134,Kimmie,67,95,62,224,74.6666666667
135,Sherie,80,50,62,192,64
136,Lorrin,63,77,79,219,73
137,Gustie,56,94,71,221,73.6666666667
138,Berti,64,64,92,220,73.3333333333
139,Philip,55,60,55,170,56.6666666667
140,Tildi,57,58,64,179,59.6666666667
141,Darsie,65,55,52,172,57.3333333333
142,Libbi,83,76,53,212,70.6666666667
143,Jacklyn,58,100,93,251,83.6666666667
144,Yvonne,72,51,88,211,70.3333333333
145,Hastie,59,67,79,205,68.3333333333
146,Adlai,75,69,87,231,77
147,Alva,82,73,59,214,71.3333333333
148,Ailyn,77,56,68,201,67
149,Archie,80,52,94,226,75.3333333333
150,Bartholomew,93,82,78,253,84.3333333333
151,Leshia,71,63,78,212,70.6666666667
152,Jordan,83,65,60,208,69.3333333333
153,Maureene,77,72,89,238,79.3333333333
154,Lucinda,87,64,93,244,81.3333333333
155,Caro,51,82,69,202,67.3333333333
156,Billy,83,52,94,229,76.3333333333
157,Alexia,82,93,88,263,87.6666666667
158,Rene,84,73,53,210,70
159,Luca,52,100,50,202,67.3333333333
160,Barri,78,77,54,209,69.6666666667
161,Ezmeralda,72,64,94,230,76.6666666667
162,Yanaton,53,90,67,210,70
163,Nate,75,89,82,246,82
164,Siegfried,72,79,81,232,77.3333333333
165,Nelson,95,55,70,220,73.3333333333
166,Royce,90,63,53,206,68.6666666667
167,Oneida,76,96,60,232,77.3333333333
168,Sholom,77,65,69,211,70.3333333333
169,Freemon,94,90,86,270,90
170,Sydel,78,100,71,249,83
171,Henrieta,61,74,98,233,77.6666666667
172,Carolin,87,76,82,245,81.6666666667
173,Collete,85,88,52,225,75
174,Corbet,83,53,81,217,72.3333333333
175,Jonell,77,85,79,241,80.3333333333
176,Cornela,60,61,85,206,68.6666666667
177,Frank,65,96,50,211,70.3333333333
178,Saloma,89,84,91,264,88
179,Opalina,96,86,86,268,89.3333333333
180,Kacie,75,72,84,231,77
181,Any,58,54,61,173,57.6666666667
182,Juan,89,52,61,202,67.3333333333
183,Aurelea,57,89,100,246,82
184,Kate,91,91,92,274,91.3333333333
185,Erik,71,60,78,209,69.6666666667
186,Hoebart,79,89,55,223,74.3333333333
187,Trista,52,68,73,193,64.3333333333
188,Micheil,86,75,81,242,80.6666666667
189,Gabie,70,100,99,269,89.6666666667
190,Natalina,88,80,88,256,85.3333333333
191,Florian,52,56,75,183,61
192,Garrek,72,83,72,227,75.6666666667
193,Sharl,95,53,98,246,82
194,Vinita,72,56,98,226,75.3333333333
195,Ross,91,76,50,217,72.3333333333
196,Jacinda,88,99,95,282,94
197,Louis,86,82,73,241,80.3333333333
198,Susann,81,67,57,205,68.3333333333
199,Pip,86,93,72,251,83.6666666667
200,Asher,57,66,99,222,74
201,Carmelia,80,86,63,229,76.3333333333
202,Tyrone,71,53,77,201,67
203,Jillane,82,50,57,189,63
204,Lettie,93,61,57,211,70.3333333333
205,Hilario,86,56,97,239,79.6666666667
206,Xymenes,98,50,58,206,68.6666666667
207,Welby,79,94,99,272,90.6666666667
208,Aubrey,50,97,99,246,82
209,Kristian,65,97,77,239,79.6666666667
210,Frances,76,67,59,202,67.3333333333
211,Nelli,64,57,91,212,70.6666666667
212,Norbert,90,59,66,215,71.6666666667
213,Dimitri,55,63,77,195,65
214,Patty,82,95,99,276,92
215,Jessey,100,89,57,246,82
216,Luciana,56,99,55,210,70
217,Ramsey,66,57,98,221,73.6666666667
218,Nomi,56,61,88,205,68.3333333333
219,Lazar,86,56,94,236,78.6666666667
220,Manny,64,73,62,199,66.3333333333
221,Michale,75,89,96,260,86.6666666667
222,Bernie,94,50,85,229,76.3333333333
223,Lilli,68,98,62,228,76
224,Alfie,81,58,57,196,65.3333333333
225,Lucais,91,50,84,225,75
226,Zackariah,57,61,74,192,64
227,Danya,99,70,71,240,80
228,Pammi,70,51,82,203,67.6666666667
229,Leila,77,86,66,229,76.3333333333
230,Minerva,59,81,95,235,78.3333333333
231,Dion,81,69,64,214,71.3333333333
232,Melissa,95,75,64,234,78
233,Morganne,86,69,84,239,79.6666666667
234,Alleen,69,82,78,229,76.3333333333
235,Porter,88,90,81,259,86.3333333333
236,Ignaz,97,52,52,201,67
237,Kendell,82,98,77,257,85.6666666667
238,Ky,70,96,52,218,72.6666666667
239,Nowell,90,52,95,237,79
240,Barbabas,95,50,96,241,80.3333333333
241,Herta,68,71,58,197,65.6666666667
242,Shaun,52,78,88,218,72.6666666667
243,Roseann,75,66,81,222,74
244,Hephzibah,74,97,72,243,81
245,Spenser,68,99,66,233,77.6666666667
246,Pru,79,66,93,238,79.3333333333
247,Arel,77,84,64,225,75
248,Sean,75,54,84,213,71
249,Laurice,65,56,96,217,72.3333333333
250,Norina,73,58,87,218,72.6666666667
251,Lars,61,60,94,215,71.6666666667
252,Silvester,94,55,59,208,69.3333333333
253,Emalee,98,74,52,224,74.6666666667
254,Bucky,86,90,60,236,78.6666666667
255,Conny,70,55,62,187,62.3333333333
256,Laureen,75,88,52,215,71.6666666667
257,Alic,89,81,95,265,88.3333333333
258,Nissy,75,96,99,270,90
259,Allen,69,98,54,221,73.6666666667
260,Jermaine,69,64,98,231,77
261,Dolph,68,99,55,222,74
262,Milt,89,88,68,245,81.6666666667
263,Ginnie,64,94,66,224,74.6666666667
264,Shepherd,50,87,66,203,67.6666666667
265,Lenci,69,66,87,222,74
266,Klement,52,91,59,202,67.3333333333
267,Amandy,62,59,73,194,64.6666666667
268,Thurston,68,54,100,222,74
269,Lorilyn,71,57,62,190,63.3333333333
270,Carlin,87,74,93,254,84.6666666667
271,Malorie,71,51,69,191,63.6666666667
272,Salomi,98,51,79,228,76
273,Dolorita,82,95,72,249,83
274,Jan,78,64,71,213,71
275,Reginald,68,56,51,175,58.3333333333
276,Milka,79,97,65,241,80.3333333333
277,Berkie,63,65,70,198,66
278,Windham,83,75,95,253,84.3333333333
279,Sashenka,83,51,78,212,70.6666666667
280,Goldia,61,64,71,196,65.3333333333
281,Gaylor,88,70,70,228,76
282,Selestina,50,74,97,221,73.6666666667
283,Clio,61,67,66,194,64.6666666667
284,Mirelle,76,76,77,229,76.3333333333
285,Erich,67,87,68,222,74
286,Jayson,78,81,88,247,82.3333333333
287,Jacquelin,96,98,50,244,81.3333333333
288,Jermaine,80,86,83,249,83
289,Beatrice,60,76,72,208,69.3333333333
290,Maire,54,52,83,189,63
291,Barret,56,90,75,221,73.6666666667
292,Arabela,54,99,61,214,71.3333333333
293,Ricki,83,91,89,263,87.6666666667
294,Jennette,85,89,99,273,91
295,Kerianne,75,51,76,202,67.3333333333
296,Christalle,65,94,66,225,75
297,Mendy,83,53,86,222,74
298,Halsey,69,51,75,195,65
299,Bari,70,80,68,218,72.6666666667
300,Nita,51,73,74,198,66
301,Mendel,79,77,84,240,80
302,Wells,59,50,90,199,66.3333333333
303,Nicola,72,56,86,214,71.3333333333
304,Jarid,83,79,86,248,82.6666666667
305,Felicle,52,69,67,188,62.6666666667
306,Gwenora,94,55,60,209,69.6666666667
307,Nikki,92,60,90,242,80.6666666667
308,Yetty,73,67,71,211,70.3333333333
309,Buckie,84,57,75,216,72
310,Kassi,61,90,76,227,75.6666666667
311,Diane-marie,57,93,63,213,71
312,Caspar,64,94,91,249,83
313,Abby,58,98,67,223,74.3333333333
314,Kathlin,68,98,58,224,74.6666666667
315,Chere,50,93,98,241,80.3333333333
316,Terrye,78,99,81,258,86
317,Elbert,80,50,50,180,60
318,Jasen,78,75,68,221,73.6666666667
319,Damian,96,76,93,265,88.3333333333
320,Marley,57,84,69,210,70
321,Dulci,61,61,51,173,57.6666666667
322,Dannie,73,53,50,176,58.6666666667
323,Lazar,73,54,95,222,74
324,Kalinda,70,90,53,213,71
325,Idalina,57,62,50,169,56.3333333333
326,Kelcey,73,92,92,257,85.6666666667
327,Agna,51,54,96,201,67
328,Erin,55,95,86,236,78.6666666667
329,Feodora,73,93,89,255,85
330,Corrie,66,73,80,219,73
331,Amandy,60,64,69,193,64.3333333333
332,Prisca,69,53,94,216,72
333,Ginger,55,77,81,213,71
334,Rosamond,79,87,68,234,78
335,Jake,80,52,59,191,63.6666666667
336,Moina,51,72,96,219,73
337,Waylin,65,70,73,208,69.3333333333
338,Lissa,89,89,88,266,88.6666666667
339,Josy,91,74,84,249,83
340,Amos,90,99,85,274,91.3333333333
341,Cleveland,89,50,99,238,79.3333333333
342,Feliza,54,56,89,199,66.3333333333
343,Demetris,88,60,90,238,79.3333333333
344,Rowe,59,73,91,223,74.3333333333
345,Matt,90,90,82,262,87.3333333333
346,Arline,94,68,80,242,80.6666666667
347,Luz,93,60,69,222,74
348,Cyndia,98,97,86,281,93.6666666667
349,Ceil,54,81,68,203,67.6666666667
350,Marcy,66,80,83,229,76.3333333333
351,Jimmie,84,72,57,213,71
352,Janna,61,53,77,191,63.6666666667
353,Garrik,59,54,69,182,60.6666666667
354,Elset,82,65,98,245,81.6666666667
355,Berna,53,60,62,175,58.3333333333
356,Travers,88,81,100,269,89.6666666667
357,Iver,94,54,85,233,77.6666666667
358,Norrie,88,95,94,277,92.3333333333
359,Ursola,91,50,81,222,74
360,Dermot,74,95,51,220,73.3333333333
361,York,100,69,60,229,76.3333333333
362,Jehu,57,77,70,204,68
363,Willyt,53,98,97,248,82.6666666667
364,Olivia,79,94,69,242,80.6666666667
365,Jeanelle,69,76,90,235,78.3333333333
366,Dorita,60,97,89,246,82
367,Diannne,73,52,77,202,67.3333333333
368,Darryl,59,51,86,196,65.3333333333
369,Garold,68,64,94,226,75.3333333333
370,Moises,100,53,87,240,80
371,Gilbert,72,60,78,210,70
372,Gar,54,65,66,185,61.6666666667
373,Kerstin,91,54,58,203,67.6666666667
374,Anastasia,66,89,89,244,81.3333333333
375,Cherianne,52,66,73,191,63.6666666667
376,Yul,78,93,88,259,86.3333333333
377,Culver,100,61,96,257,85.6666666667
378,Vladamir,83,62,86,231,77
379,Aurel,98,81,66,245,81.6666666667
380,Christie,77,94,80,251,83.6666666667
381,Barbi,83,72,99,254,84.6666666667
382,Finn,69,66,53,188,62.6666666667
383,Bendicty,63,58,91,212,70.6666666667
384,Kally,71,66,100,237,79
385,Joella,66,96,95,257,85.6666666667
386,Sacha,53,59,75,187,62.3333333333
387,Nev,51,84,64,199,66.3333333333
388,Betsey,70,97,59,226,75.3333333333
389,Westleigh,85,81,74,240,80
390,Gibb,52,93,88,233,77.6666666667
391,Sisile,89,87,74,250,83.3333333333
392,Reid,95,100,90,285,95
393,Wyatan,85,100,69,254,84.6666666667
394,Tildie,90,58,64,212,70.6666666667
395,Anabelle,93,74,63,230,76.6666666667
396,Parry,71,93,57,221,73.6666666667
397,Gregorio,53,82,77,212,70.6666666667
398,Ker,99,88,65,252,84
399,Wang,79,92,56,227,75.6666666667
400,Isobel,85,96,55,236,78.6666666667
401,Sonia,84,68,85,237,79
402,Javier,70,78,80,228,76
403,Gavin,80,53,77,210,70
404,Aurthur,74,82,88,244,81.3333333333
405,Lawry,99,56,71,226,75.3333333333
406,Cordey,98,66,67,231,77
407,Ollie,83,89,52,224,74.6666666667
408,Marti,76,73,83,232,77.3333333333
409,Ellissa,81,70,86,237,79
410,Hanny,60,82,97,239,79.6666666667
411,Aylmer,73,59,70,202,67.3333333333
412,Hildagarde,64,98,61,223,74.3333333333
413,Laurene,54,64,85,203,67.6666666667
414,Brittni,95,94,65,254,84.6666666667
415,Adler,63,73,94,230,76.6666666667
416,Nona,93,78,68,239,79.6666666667
417,Shelley,54,92,98,244,81.3333333333
418,Montague,91,93,50,234,78
419,Betsy,54,76,97,227,75.6666666667
420,Gwenneth,83,75,96,254,84.6666666667
421,Ardelis,56,66,62,184,61.3333333333
422,Allister,71,91,71,233,77.6666666667
423,Garth,97,100,76,273,91
424,Brigida,87,67,83,237,79
425,Stephana,83,67,59,209,69.6666666667
426,Doug,81,72,62,215,71.6666666667
427,Goldia,75,69,93,237,79
428,June,70,95,92,257,85.6666666667
429,Renard,50,93,54,197,65.6666666667
430,Robbin,97,55,74,226,75.3333333333
431,Stanton,79,62,57,198,66
432,Gerhard,50,53,77,180,60
433,Urbano,78,85,50,213,71
434,Gisele,78,66,97,241,80.3333333333
435,Sidoney,75,50,76,201,67
436,Arlin,80,73,57,210,70
437,Barnie,56,66,90,212,70.6666666667
438,Bette,91,50,63,204,68
439,Kalvin,79,99,84,262,87.3333333333
440,Windham,64,67,62,193,64.3333333333
441,Dev,69,94,51,214,71.3333333333
442,Rhoda,63,88,50,201,67
443,Karissa,67,72,89,228,76
444,Gloriane,58,68,65,191,63.6666666667
445,Marshal,71,66,72,209,69.6666666667
446,Bellina,98,59,67,224,74.6666666667
447,Marje,87,60,82,229,76.3333333333
448,Daniele,66,95,75,236,78.6666666667
449,Jacquie,60,92,52,204,68
450,Zandra,87,54,98,239,79.6666666667
451,Jennilee,86,81,85,252,84
452,Cornela,62,100,97,259,86.3333333333
453,Gil,66,64,64,194,64.6666666667
454,Mae,54,60,90,204,68
455,Cosetta,89,84,82,255,85
456,Sophia,59,62,87,208,69.3333333333
457,Rudolfo,76,75,60,211,70.3333333333
458,Halley,78,52,72,202,67.3333333333
459,Llewellyn,75,73,58,206,68.6666666667
460,Broddie,96,60,96,252,84
461,Rosette,94,91,87,272,90.6666666667
462,Kamillah,50,87,77,214,71.3333333333
463,Jacquenetta,96,59,58,213,71
464,Levy,95,52,64,211,70.3333333333
465,Carmella,93,73,67,233,77.6666666667
466,Bili,52,85,100,237,79
467,Rosemarie,82,52,64,198,66
468,Byrle,67,98,60,225,75
469,Ann,98,72,51,221,73.6666666667
470,Grove,65,83,79,227,75.6666666667
471,Allyson,85,68,63,216,72
472,Susannah,63,74,73,210,70
473,Caitlin,65,100,81,246,82
474,Dieter,69,65,72,206,68.6666666667
475,Shelden,55,81,92,228,76
476,Brana,77,58,86,221,73.6666666667
477,Alard,83,73,99,255,85
478,Casper,93,51,62,206,68.6666666667
479,Etta,83,91,65,239,79.6666666667
480,Falito,85,89,71,245,81.6666666667
481,Chanda,95,74,74,243,81
482,Heidi,93,60,56,209,69.6666666667
483,Bernhard,77,97,92,266,88.6666666667
484,Gib,67,81,83,231,77
485,Rorke,70,75,92,237,79
486,Bernardina,89,91,73,253,84.3333333333
487,Horatia,63,53,50,166,55.3333333333
488,Adara,95,55,82,232,77.3333333333
489,Bert,70,84,78,232,77.3333333333
490,Nikola,92,100,100,292,97.3333333333
491,Jobina,73,94,60,227,75.6666666667
492,Berke,62,90,56,208,69.3333333333
493,Craggy,77,98,66,241,80.3333333333
494,L;urette,77,57,63,197,65.6666666667
495,Jermaine,79,73,84,236,78.6666666667
496,Koenraad,59,57,73,189,63
497,Leyla,77,83,72,232,77.3333333333
498,Madelon,53,65,75,193,64.3333333333
499,Fred,91,94,83,268,89.3333333333
500,Jeno,54,85,76,215,71.6666666667
501,Kermy,75,99,55,229,76.3333333333
502,Margy,61,77,69,207,69
503,Kailey,83,79,73,235,78.3333333333
504,Gerhardt,76,51,84,211,70.3333333333
505,Weidar,85,57,84,226,75.3333333333
506,Cassandre,93,76,92,261,87
507,Raphael,86,88,69,243,81
508,Lula,64,77,56,197,65.6666666667
509,Etan,96,63,97,256,85.3333333333
510,Reagan,53,99,96,248,82.6666666667
511,Mordecai,72,84,55,211,70.3333333333
512,Van,58,71,64,193,64.3333333333
513,Joseito,97,59,92,248,82.6666666667
514,Hildy,55,94,67,216,72
515,Davidson,87,65,85,237,79
516,Steven,52,54,71,177,59
517,Ortensia,87,83,93,263,87.6666666667
518,Lettie,59,59,65,183,61
519,Ivett,53,66,90,209,69.6666666667
520,Valenka,57,51,70,178,59.3333333333
521,Dynah,60,75,88,223,74.3333333333
522,Delphinia,94,99,61,254,84.6666666667
523,Ariela,87,64,51,202,67.3333333333
524,Rees,87,84,65,236,78.6666666667
525,Jermayne,90,91,66,247,82.3333333333
526,Cris,58,96,55,209,69.6666666667
527,Eal,53,83,96,232,77.3333333333
528,Golda,58,98,80,236,78.6666666667
529,Jacinthe,57,91,75,223,74.3333333333
530,Hadleigh,77,77,62,216,72
531,Lezley,66,92,51,209,69.6666666667
532,Dannie,53,72,76,201,67
533,Valma,98,53,64,215,71.6666666667
534,Daveen,65,80,53,198,66
535,Felicdad,95,78,91,264,88
536,Suzann,65,71,96,232,77.3333333333
537,Corby,67,92,79,238,79.3333333333
538,Rozele,59,56,82,197,65.6666666667
539,Tine,84,51,97,232,77.3333333333
540,Anatollo,83,96,54,233,77.6666666667
541,Jeremiah,81,51,92,224,74.6666666667
542,Herman,77,89,82,248,82.6666666667
543,Janean,88,88,88,264,88
544,Seana,92,79,100,271,90.3333333333
545,Brendan,75,100,74,249,83
546,Muriel,56,63,64,183,61
547,Rheta,50,93,70,213,71
548,Gypsy,68,53,63,184,61.3333333333
549,Horatia,69,74,64,207,69
550,Eddie,89,86,93,268,89.3333333333
551,Devora,63,76,90,229,76.3333333333
552,Addy,87,80,81,248,82.6666666667
553,Susannah,56,86,86,228,76
554,Angel,67,95,65,227,75.6666666667
555,Artemus,96,76,93,265,88.3333333333
556,Jaye,56,87,76,219,73
557,Maximilianus,73,96,76,245,81.6666666667
558,Curt,56,70,76,202,67.3333333333
559,Cletis,72,74,73,219,73
560,Cyrillus,74,72,64,210,70
561,Bryana,56,98,96,250,83.3333333333
562,Eamon,79,64,58,201,67
563,Cordi,97,50,88,235,78.3333333333
564,Sydney,99,77,70,246,82
565,Livvyy,82,59,88,229,76.3333333333
566,Daryl,56,61,83,200,66.6666666667
567,Gwenni,84,79,62,225,75
568,Kristoforo,90,81,58,229,76.3333333333
569,Rochell,51,66,50,167,55.6666666667
570,Elmore,100,63,91,254,84.6666666667
571,Jayson,73,95,74,242,80.6666666667
572,Karlyn,82,80,64,226,75.3333333333
573,Ricardo,73,80,57,210,70
574,Dene,55,68,75,198,66
575,Hinze,52,65,66,183,61
576,Robinson,94,88,95,277,92.3333333333
577,Benito,95,72,62,229,76.3333333333
578,Gavin,72,67,63,202,67.3333333333
579,Codie,58,61,75,194,64.6666666667
580,Hillary,58,67,91,216,72
581,Maggie,83,93,92,268,89.3333333333
582,Lily,83,72,73,228,76
583,Billie,83,90,58,231,77
584,Sawyer,52,57,69,178,59.3333333333
585,Marinna,86,90,88,264,88
586,Denny,51,63,81,195,65
587,Drona,69,69,72,210,70
588,Jean,90,70,83,243,81
589,Sigismondo,55,78,54,187,62.3333333333
590,Nataline,99,84,100,283,94.3333333333
591,Dulcinea,96,97,68,261,87
592,Hewitt,95,99,82,276,92
593,Myriam,66,53,88,207,69
594,Gisella,55,59,63,177,59
595,Finn,51,80,88,219,73
596,Kora,56,62,88,206,68.6666666667
597,Krysta,67,64,96,227,75.6666666667
598,Reider,71,89,51,211,70.3333333333
599,Micheil,59,53,88,200,66.6666666667
600,Eadmund,65,58,91,214,71.3333333333
601,Skipper,79,72,87,238,79.3333333333
602,Micaela,81,82,100,263,87.6666666667
603,Lisette,70,90,88,248,82.6666666667
604,Arline,89,100,83,272,90.6666666667
605,Pierre,59,94,94,247,82.3333333333
606,Granger,94,81,83,258,86
607,Venita,50,88,61,199,66.3333333333
608,Alfonso,98,77,63,238,79.3333333333
609,Brianne,89,93,55,237,79
610,Tandy,86,72,75,233,77.6666666667
611,Vernon,57,59,95,211,70.3333333333
612,Garrek,64,53,52,169,56.3333333333
613,Marcus,91,68,75,234,78
614,Nolan,78,67,73,218,72.6666666667
615,Dusty,88,57,78,223,74.3333333333
616,Brooke,88,84,57,229,76.3333333333
617,Penny,68,96,71,235,78.3333333333
618,Goldina,69,99,79,247,82.3333333333
619,Georgine,53,54,100,207,69
620,Marie-jeanne,56,53,100,209,69.6666666667
621,Nessie,67,62,69,198,66
622,Fayina,98,90,63,251,83.6666666667
623,Aldin,68,79,57,204,68
624,Kinny,99,91,59,249,83
625,Deidre,79,73,74,226,75.3333333333
626,Farica,72,66,58,196,65.3333333333
627,Mia,57,93,53,203,67.6666666667
628,Fawn,100,67,72,239,79.6666666667
629,Allegra,78,84,54,216,72
630,Betsy,85,61,58,204,68
631,Tuesday,88,93,83,264,88
632,Had,88,59,68,215,71.6666666667
633,Doralynne,54,58,84,196,65.3333333333
634,Wilhelm,52,89,92,233,77.6666666667
635,Craggie,87,93,80,260,86.6666666667
636,Rowney,69,74,50,193,64.3333333333
637,Noah,79,92,56,227,75.6666666667
638,Kassey,86,66,71,223,74.3333333333
639,Alyson,55,78,59,192,64
640,Camilla,73,88,92,253,84.3333333333
641,Ellsworth,75,57,92,224,74.6666666667
642,Wernher,90,84,61,235,78.3333333333
643,Glenna,66,60,84,210,70
644,Candra,77,74,55,206,68.6666666667
645,Genevieve,100,59,66,225,75
646,Bessie,50,62,52,164,54.6666666667
647,Annora,51,66,100,217,72.3333333333
648,Armin,98,55,82,235,78.3333333333
649,Powell,72,66,56,194,64.6666666667
650,Sherlock,75,77,78,230,76.6666666667
651,Alaster,92,97,83,272,90.6666666667
652,Bridgette,59,89,75,223,74.3333333333
653,Elton,85,72,63,220,73.3333333333
654,Kenny,85,70,100,255,85
655,Sharon,100,71,95,266,88.6666666667
656,Petey,65,91,81,237,79
657,Osbourn,57,83,74,214,71.3333333333
658,Zelda,53,99,68,220,73.3333333333
659,Nicolea,90,61,67,218,72.6666666667
660,Lion,64,72,56,192,64
661,Michelina,53,52,69,174,58
662,Colline,72,97,89,258,86
663,Mersey,99,94,61,254,84.6666666667
664,Rosamund,94,57,99,250,83.3333333333
665,Pegeen,99,68,85,252,84
666,Carlina,65,75,95,235,78.3333333333
667,Zea,59,53,57,169,56.3333333333
668,Glori,65,100,58,223,74.3333333333
669,Stafani,98,59,100,257,85.6666666667
670,Kurt,98,92,81,271,90.3333333333
671,Lacee,73,79,88,240,80
672,Rufus,83,59,66,208,69.3333333333
673,Sunny,92,81,62,235,78.3333333333
674,Natasha,81,82,88,251,83.6666666667
675,Crysta,50,88,50,188,62.6666666667
676,Aaron,70,87,75,232,77.3333333333
677,Cyrillus,79,91,51,221,73.6666666667
678,Carter,58,59,51,168,56
679,Emma,60,98,97,255,85
680,Laetitia,88,62,81,231,77
681,Marcy,90,80,85,255,85
682,Alexa,50,80,83,213,71
683,Mathew,55,85,89,229,76.3333333333
684,Keelby,76,64,89,229,76.3333333333
685,Zolly,65,80,80,225,75
686,Rhodia,95,75,59,229,76.3333333333
687,Bernetta,50,62,67,179,59.6666666667
688,Ly,57,98,53,208,69.3333333333
689,Emmett,100,70,62,232,77.3333333333
690,Robyn,79,94,100,273,91
691,Kennedy,57,83,58,198,66
692,Leandra,70,65,58,193,64.3333333333
693,Mikaela,82,100,62,244,81.3333333333
694,Abelard,66,82,61,209,69.6666666667
695,Perry,90,99,55,244,81.3333333333
696,Chiquita,54,56,94,204,68
697,Jeff,87,95,51,233,77.6666666667
698,Myriam,52,58,65,175,58.3333333333
699,Samara,89,73,61,223,74.3333333333
700,Clarence,85,80,66,231,77
701,Gardy,78,66,90,234,78
702,Evelin,81,100,55,236,78.6666666667
703,Sammy,61,65,90,216,72
704,Raddy,84,83,72,239,79.6666666667
705,Llewellyn,60,68,95,223,74.3333333333
706,Cinderella,97,68,85,250,83.3333333333
707,Duncan,89,79,99,267,89
708,Damaris,96,74,77,247,82.3333333333
709,Karel,68,84,92,244,81.3333333333
710,Cello,52,95,95,242,80.6666666667
711,Jae,52,55,76,183,61
712,Pablo,64,90,64,218,72.6666666667
713,Yehudit,87,94,65,246,82
714,Trina,76,57,72,205,68.3333333333
715,Bernard,83,96,99,278,92.6666666667
716,Julieta,83,68,53,204,68
717,Sascha,65,80,59,204,68
718,Giffer,64,77,55,196,65.3333333333
719,Jewelle,77,58,63,198,66
720,Timi,54,51,100,205,68.3333333333
721,Kesley,96,70,98,264,88
722,Horace,76,55,78,209,69.6666666667
723,Stephi,83,90,77,250,83.3333333333
724,Orion,65,70,76,211,70.3333333333
725,Myrwyn,63,90,50,203,67.6666666667
726,Vilhelmina,53,85,78,216,72
727,Goldy,86,70,92,248,82.6666666667
728,Giralda,55,78,58,191,63.6666666667
729,Bertina,57,79,67,203,67.6666666667
730,Claiborne,80,89,94,263,87.6666666667
731,Tirrell,71,59,56,186,62
732,Arabela,96,62,88,246,82
733,Bogey,94,90,51,235,78.3333333333
734,Nicolais,50,58,93,201,67
735,Malissia,85,59,60,204,68
736,Callida,86,81,74,241,80.3333333333
737,Abie,69,81,68,218,72.6666666667
738,Danya,81,90,79,250,83.3333333333
739,Faustina,94,97,80,271,90.3333333333
740,Vachel,59,100,71,230,76.6666666667
741,Cullin,69,71,100,240,80
742,Gerri,71,81,70,222,74
743,Sheelagh,66,51,50,167,55.6666666667
744,Lora,55,83,79,217,72.3333333333
745,Anallese,55,65,50,170,56.6666666667
746,Kenn,73,58,50,181,60.3333333333
747,Dedie,86,84,73,243,81
748,Neddie,93,87,93,273,91
749,Garvin,78,81,51,210,70
750,Aurelea,92,98,69,259,86.3333333333
751,Shana,63,61,74,198,66
752,Caritta,87,73,60,220,73.3333333333
753,Wilbur,95,76,68,239,79.6666666667
754,Feodora,76,56,81,213,71
755,Bekki,65,96,72,233,77.6666666667
756,Rhetta,88,79,81,248,82.6666666667
757,Marcelo,79,53,77,209,69.6666666667
758,Celene,55,100,58,213,71
759,Roseanne,85,50,90,225,75
760,Tabbi,89,66,77,232,77.3333333333
761,Brynn,83,72,99,254,84.6666666667
762,Rianon,88,86,89,263,87.6666666667
763,Cloe,94,85,87,266,88.6666666667
764,Niles,74,77,58,209,69.6666666667
765,Katrinka,73,69,58,200,66.6666666667
766,Collin,99,91,73,263,87.6666666667
767,Zacharie,91,72,78,241,80.3333333333
768,Rycca,63,84,77,224,74.6666666667
769,Aeriel,83,88,92,263,87.6666666667
770,Netti,87,85,55,227,75.6666666667
771,Katrina,66,69,85,220,73.3333333333
772,Olympia,76,88,79,243,81
773,Mavis,52,67,85,204,68
774,Ondrea,63,76,89,228,76
775,Adamo,99,82,82,263,87.6666666667
776,Iona,95,79,74,248,82.6666666667
777,Mildred,65,71,82,218,72.6666666667
778,Jobi,92,86,68,246,82
779,Marguerite,97,90,97,284,94.6666666667
780,Lorne,75,55,62,192,64
781,Kare,90,87,55,232,77.3333333333
782,Dene,65,97,60,222,74
783,Mendie,62,97,93,252,84
784,Jamima,99,66,87,252,84
785,Darb,75,51,72,198,66
786,Boony,83,87,56,226,75.3333333333
787,Lazarus,74,83,90,247,82.3333333333
788,Livvy,81,98,86,265,88.3333333333
789,Kerwinn,67,73,53,193,64.3333333333
790,Adair,90,85,91,266,88.6666666667
791,Irene,55,73,82,210,70
792,Gilly,64,97,67,228,76
793,Kane,86,55,60,201,67
794,Kelsi,81,70,52,203,67.6666666667
795,Kevina,61,51,79,191,63.6666666667
796,Richardo,92,77,85,254,84.6666666667
797,Eveleen,95,64,64,223,74.3333333333
798,Mona,85,89,58,232,77.3333333333
799,Leonidas,93,59,83,235,78.3333333333
800,Elisabetta,84,72,84,240,80
801,Kerwinn,98,51,51,200,66.6666666667
802,Christan,80,90,86,256,85.3333333333
803,Latrina,100,71,61,232,77.3333333333
804,Carilyn,73,93,87,253,84.3333333333
805,Kandace,79,84,85,248,82.6666666667
806,Ennis,56,83,77,216,72
807,Archibold,92,57,78,227,75.6666666667
808,Teena,88,52,81,221,73.6666666667
809,Kennedy,81,81,95,257,85.6666666667
810,Howey,99,81,69,249,83
811,Ronny,61,76,54,191,63.6666666667
812,Dominga,55,89,77,221,73.6666666667
813,Ritchie,52,92,55,199,66.3333333333
814,Alphard,66,72,89,227,75.6666666667
815,Adolphe,78,73,82,233,77.6666666667
816,Chrissie,65,93,60,218,72.6666666667
817,Trever,81,95,91,267,89
818,Katerine,72,76,72,220,73.3333333333
819,Tessie,61,50,97,208,69.3333333333
820,Nelle,85,92,69,246,82
821,Eddy,64,68,57,189,63
822,Veda,74,93,55,222,74
823,Ernesto,71,77,99,247,82.3333333333
824,Tam,56,58,69,183,61
825,Valeda,82,99,79,260,86.6666666667
826,Ninon,60,76,90,226,75.3333333333
827,Laryssa,97,76,82,255,85
828,Jobina,87,84,54,225,75
829,Flinn,71,85,60,216,72
830,Darrelle,86,76,70,232,77.3333333333
831,Florida,72,85,96,253,84.3333333333
832,Levin,84,80,77,241,80.3333333333
833,Kristan,89,69,88,246,82
834,Estele,100,54,73,227,75.6666666667
835,Todd,76,86,97,259,86.3333333333
836,Evvy,73,69,56,198,66
837,Serena,67,91,95,253,84.3333333333
838,Cleopatra,95,54,87,236,78.6666666667
839,Leopold,59,95,97,251,83.6666666667
840,Dani,82,99,84,265,88.3333333333
841,Tuck,74,79,54,207,69
842,Marion,80,57,85,222,74
843,Robbie,80,60,93,233,77.6666666667
844,Sisile,94,91,87,272,90.6666666667
845,Myrtie,58,97,70,225,75
846,Ula,52,57,65,174,58
847,Arlen,89,80,81,250,83.3333333333
848,Camila,86,95,62,243,81
849,Niles,88,63,82,233,77.6666666667
850,Chevy,74,68,62,204,68
851,Ancell,66,57,95,218,72.6666666667
852,Monro,94,91,57,242,80.6666666667
853,Bondy,87,61,67,215,71.6666666667
854,Kassie,72,77,90,239,79.6666666667
855,Othello,55,70,72,197,65.6666666667
856,Hilary,84,92,100,276,92
857,Shelden,83,57,60,200,66.6666666667
858,Casi,58,75,54,187,62.3333333333
859,Petronille,70,71,53,194,64.6666666667
860,Fredrick,65,71,93,229,76.3333333333
861,Clo,58,93,71,222,74
862,Jsandye,75,67,51,193,64.3333333333
863,Ardra,89,59,94,242,80.6666666667
864,Cleavland,91,66,94,251,83.6666666667
865,Nikkie,85,55,74,214,71.3333333333
866,Aurore,67,97,54,218,72.6666666667
867,Dionysus,82,58,59,199,66.3333333333
868,Bert,65,88,55,208,69.3333333333
869,Brianne,97,92,77,266,88.6666666667
870,Breanne,56,56,94,206,68.6666666667
871,Rhea,66,82,67,215,71.6666666667
872,Ashlen,65,58,57,180,60
873,Reuben,71,67,83,221,73.6666666667
874,Kayley,76,72,85,233,77.6666666667
875,Brigida,75,59,59,193,64.3333333333
876,Betsey,52,68,94,214,71.3333333333
877,Parke,59,63,95,217,72.3333333333
878,Tarrance,86,63,74,223,74.3333333333
879,Kippy,56,75,80,211,70.3333333333
880,Leeland,79,65,89,233,77.6666666667
881,Brear,94,100,98,292,97.3333333333
882,Shena,54,75,58,187,62.3333333333
883,Marris,69,59,81,209,69.6666666667
884,Dorella,79,87,91,257,85.6666666667
885,Rutherford,71,55,96,222,74
886,Giffie,77,66,94,237,79
887,Ellyn,50,85,68,203,67.6666666667
888,Pieter,90,65,61,216,72
889,Alfredo,90,62,74,226,75.3333333333
890,Rolfe,59,67,81,207,69
891,Elfrida,75,88,65,228,76
892,Spike,65,93,52,210,70
893,Tedman,56,63,73,192,64
894,Amelie,69,59,96,224,74.6666666667
895,Ula,51,95,81,227,75.6666666667
896,Karlyn,94,55,50,199,66.3333333333
897,Ransell,60,70,76,206,68.6666666667
898,Stearne,100,56,57,213,71
899,Reilly,66,57,78,201,67
900,Vallie,78,94,88,260,86.6666666667
901,Francklin,67,86,95,248,82.6666666667
902,Ertha,72,76,68,216,72
903,Jade,62,70,52,184,61.3333333333
904,Kenon,64,73,67,204,68
905,Elfrida,96,82,76,254,84.6666666667
906,Shelby,77,55,69,201,67
907,Guinevere,94,97,71,262,87.3333333333
908,Natividad,80,62,96,238,79.3333333333
909,Emerson,53,73,92,218,72.6666666667
910,Michaeline,95,98,56,249,83
911,Ashbey,57,87,80,224,74.6666666667
912,Wilhelmine,87,78,63,228,76
913,Doralia,52,100,89,241,80.3333333333
914,Jocko,97,50,83,230,76.6666666667
915,Stephanie,94,72,51,217,72.3333333333
916,Wynne,79,53,56,188,62.6666666667
917,Minta,76,89,73,238,79.3333333333
918,Fionnula,64,61,89,214,71.3333333333
919,Marylinda,50,92,56,198,66
920,Kenton,64,78,66,208,69.3333333333
921,Emilia,77,54,65,196,65.3333333333
922,Vivien,77,72,93,242,80.6666666667
923,Elsinore,59,86,75,220,73.3333333333
924,Manfred,85,81,69,235,78.3333333333
925,Daffie,55,90,93,238,79.3333333333
926,Rikki,58,99,87,244,81.3333333333
927,Goldie,90,83,93,266,88.6666666667
928,Nancee,94,91,81,266,88.6666666667
929,Edvard,98,98,90,286,95.3333333333
930,Kary,70,94,56,220,73.3333333333
931,Maxy,82,93,64,239,79.6666666667
932,Thornie,76,50,63,189,63
933,Lazar,89,50,72,211,70.3333333333
934,Basile,78,97,58,233,77.6666666667
935,Dewey,82,64,87,233,77.6666666667
936,Florie,88,93,93,274,91.3333333333
937,Zollie,55,69,50,174,58
938,Charyl,70,97,83,250,83.3333333333
939,Francine,53,96,64,213,71
940,Fancy,94,77,79,250,83.3333333333
941,Brnaba,51,89,76,216,72
942,Nehemiah,60,82,81,223,74.3333333333
943,Larisa,77,71,98,246,82
944,Thia,69,68,73,210,70
945,Aindrea,52,63,67,182,60.6666666667
946,Gennie,54,81,63,198,66
947,Welsh,55,81,85,221,73.6666666667
948,Rockwell,76,85,54,215,71.6666666667
949,Barret,62,94,94,250,83.3333333333
950,Fannie,74,71,86,231,77
951,Anestassia,92,67,83,242,80.6666666667
952,Jasun,97,82,99,278,92.6666666667
953,Aridatha,81,72,79,232,77.3333333333
954,Emmerich,51,56,95,202,67.3333333333
955,Willi,73,99,96,268,89.3333333333
956,Leeland,79,76,73,228,76
957,Arturo,100,83,84,267,89
958,Minnaminnie,69,92,89,250,83.3333333333
959,Roseann,85,91,100,276,92
960,Valaree,99,51,71,221,73.6666666667
961,Benedetta,71,59,81,211,70.3333333333
962,Joshia,55,53,75,183,61
963,Eran,65,50,74,189,63
964,Carlie,64,68,54,186,62
965,Marika,100,81,63,244,81.3333333333
966,Kanya,69,92,70,231,77
967,Lesli,92,99,88,279,93
968,Tiphanie,70,80,85,235,78.3333333333
969,Darla,53,64,77,194,64.6666666667
970,Ruby,82,81,83,246,82
971,Atlanta,85,56,86,227,75.6666666667
972,Lindi,73,57,91,221,73.6666666667
973,Chanda,79,81,79,239,79.6666666667
974,Beth,64,67,92,223,74.3333333333
975,Rolf,91,100,86,277,92.3333333333
976,Filmer,92,100,70,262,87.3333333333
977,Nanice,84,70,58,212,70.6666666667
978,Aubrie,53,74,70,197,65.6666666667
979,Lek,84,65,93,242,80.6666666667
980,Vachel,52,93,87,232,77.3333333333
981,Reeba,81,70,65,216,72
982,Lazarus,76,67,53,196,65.3333333333
983,Hamil,86,54,53,193,64.3333333333
984,Kelly,74,53,54,181,60.3333333333
985,Perle,61,100,75,236,78.6666666667
986,Jerrine,100,59,96,255,85
987,Harbert,62,54,66,182,60.6666666667
988,Gusty,53,88,69,210,70
989,Parnell,73,81,65,219,73
990,Ilise,55,72,70,197,65.6666666667
991,Rikki,81,90,100,271,90.3333333333
992,Madelon,65,99,69,233,77.6666666667
993,Dione,88,52,98,238,79.3333333333
994,Gertrud,84,59,77,220,73.3333333333
995,Jacquetta,74,76,51,201,67
996,Gary,61,85,91,237,79
997,Deeann,92,68,99,259,86.3333333333
998,Odelinda,72,75,90,237,79
999,Alaine,89,53,84,226,75.3333333333
1000,Griffy,77,78,96,251,83.6666666667
